C                       0,125,255

WE                   ./textures/eagle.xpm

EA ./textures/greystone.xpm


SO ./textures/wood.xpm

F  0,143,85


NO ./textures/purplestone.xpm

1111111111111111111111111111111111
10000000000000000000E0000000000001
1110111111111111111111111111111111
1000000000000001110000000000000001
1000000000000000000000000000000001
1000000000000001000000000000000001
1000000000000011100000000000000011
1100000000000001000000000000000011
1000000000000000000000000000000001
1000000000000000000000000000000001
1000000000000000100000000000000001
1111111111111111111111111111111111