F                       128,128,128

WE                   ./textures/redstone.xpm

EA ./textures/diamond.xpm


SO ./textures/iron.xpm

C  32,32,32


NO ./textures/gold.xpm

1111111111111111111111111111111111
10000000000000000000W0000000000001
1110111111111111111111111111111111
1000000000000001110000000000000001
1000000000000000000000000000000001
1000000000000001000000000000000001
1000000000000011100000000000000011
1100000000000001000000000000000011
1000000000000000000000000000000001
1000000000000000000000000000000001
1000000000000000100000000000000001
1111111111111111111111111111111111
