NO ./textures/diamond.xpm
SO ./textures/gold.xpm
WE ./textures/iron.xpm
EA ./textures/redstone.xpm
F 128,128,128
C 32,32,32

111111111111111111111111111111111111111111111111
100010000000000001000000100000000000001000010001
101010101010101001010101010101010101010101010101
100000001000000000000000100000000000000000000001
101010101010101010101010101010101010101010101011
100000000000000000000001000000000000000000000001
101010101010101010101010101010101010101010101011
100000000000000000000001000000000000000000000001
101010101010101010101010101010101010101010101011
100000001000000000000000100000000000000000000001
101010101010101010101010101010101010101010101011
100010000000000001000000100000000000001000010001
101010101010101001010101010101010101010101010101
100000001000000000000000100000000000000000000001
101010101010101010101010101010101010101010101011
100000000000000000000001000000000000000000000001
101010101010101010101010101010101010101010101011
100000000000000000000001000000000000000000000001
101010101010101010101010101010101010101010101011
100000001000000000000000100000000000000000000001
101010101010101001010101010101010101010101010101
1000100000000000010000001000000000000010000100N1
111111111111111111111111111111111111111111111111
