NO ./textures/diamond.xpm
SO ./textures/gold.xpm
WE ./textures/iron.xpm
EA ./textures/redstone.xpm
F 192,192,192
C 32,32,32

111111111111111111111111111111111111111111111111
100000000000000000000000N00000000000000000000001
101111111111111111111111111111111111111111111101
100000000000000000000000000000000000000000000001
101111111111111111111111111111111111111111111101
100000000000000000000000000000000000000000000001
101111111111111111111111111111111111111111111101
100000000000000000000000000000000000000000000001
101111111111111111111111111111111111111111111101
100000000000000000000000000000000000000000000001
101111111111111111111111111111111111111111111101
100000000000000000000000000000000000000000000001
111111111111111111111111111111111111111111111111
